1 kg 2lb cauliflower florets	Fruits, légumes
2 garlic cloves peeled whole	Fruits, légumes
2 tbsp (30g) unsalted butter	Produits laitiers, oeufs, fromages
1 4 cup (25g) parmesan cheese shredded	Produits laitiers, oeufs, fromages
1 4 cup (55g) sour cream optional	Produits laitiers, oeufs, fromages
 Salt	Epicerie salée
 Melted butter	Produits laitiers, oeufs, fromages
farine pour le moule	Epicerie sucrée
beurre	Produits laitiers, oeufs, fromages
10 cl d huile	Epicerie salée
1 sachet de levure	Epicerie sucrée
100 g de farine	Epicerie sucrée
100 g d emmental râpé	Produits laitiers, oeufs, fromages
300 g de thon au naturel	Epicerie salée
100 g d olives vertes ou noires dénoyautées	Epicerie salée
3 oeufs	Produits laitiers, oeufs, fromages
10 cl de lait	Produits laitiers, oeufs, fromages
180 g chocolate	Epicerie sucrée
110 g butter	Produits laitiers, oeufs, fromages
3 medium eggs	Produits laitiers, oeufs, fromages
200 g sugar	Epicerie sucrée
80 g flour	Epicerie sucrée
30 g cocoa powder	Epicerie sucrée
sel	Epicerie salée
poivre	Epicerie salée
huile d olive	Epicerie salée
vinaigre de vin rouge	Epicerie salée
1 poivron vert	Fruits, légumes
4 tomates rondes assez fermes	Fruits, légumes
4 oeufs	Produits laitiers, oeufs, fromages
2 oignons cébettes (ou petits oignons)	Fruits, légumes
8 févettes (petites fèves)	Fruits, légumes
200 g de thon au naturel	Epicerie salée
4 filets d anchois au sel	Epicerie salée
olives noires de Nice	Fruits, légumes
feuille de basilic	Fruits, légumes
8 radis	Fruits, légumes
4 artichauts violets à l huile	Fruits, légumes